{
  "backgroundColor": "darkseagreen",
  "map": [
    [2, 1, 1, 2, 0, 0, 0, 0, 2, 3],
    [1, 0, 0, 0, 1, 0, 0, 1, 1, 3],
    [1, 0, 0, 0, 0, 0, 0, 0, 5, 3],
    [0, 1, 0, 0, 0, 0, 0, 0, 0, 3],
    [0, 0, 0, 0, 0, 0, 0, 0, 0, 3],
    [0, 1, 0, 0, 0, 0, 0, 0, 0, 3],
    [1, 1, 0, 0, 0, 0, 1, 0, 0, 3],
    [1, 0, 0, 0, 1, 0, 0, 1, 0, 3],
    [3, 1, 0, 0, 0, 0, 0, 0, 1, 3],
    [3, 2, 0, 0, 0, 0, 1, 1, 1, 3]
  ],
  "exits": {
    "north": "level4",
    "south": "level12",
    "west": "level7"
  }
}