{
  "backgroundColor": "darkseagreen",
  "map": [
    [2, 2, 2, 2, 2, 2, 2, 2, 2, 2],
    [2, 0, 0, 0, 0, 0, 0, 1, 0, 2],
    [2, 2, 0, 0, 0, 0, 0, 0, 0, 2],
    [2, 1, 0, 0, 0, 0, 0, 0, 0, 0],
    [2, 0, 0, 0, 0, 0, 0, 0, 0, 0],
    [2, 0, 0, 0, 0, 0, 0, 0, 0, 1],
    [2, 0, 0, 0, 0, 0, 1, 0, 0, 1],
    [2, 2, 0, 5, 1, 0, 0, 0, 0, 0],
    [2, 2, 0, 0, 0, 0, 0, 0, 1, 0],
    [2, 2, 0, 0, 0, 0, 0, 2, 2, 2]
  ],
  "exits": {
    "south": "level14",
    "east": "level11"
  }
}